11111111111111111
10000000C00000001
101E0101010110101
1P100100000110101
100000000000000C1
11111111111111111